3333333333
2222222222
1111111111
P2P2P2P2P2
2222222222
