1111111111
1111111111
2222222222
1111111111
P1P1P1P1P1
