3333333333
2P2P2P2P2P
2222222222
1P1P1P1P1P
1111111111
