2222222222
2111111112
2111111112
2111111112
3333333333
1111111111

